8 8
1 1 1 1 1 1 1 1
1 1 1 4 1 1 1 1
1 1 1 0 1 1 1 1
1 1 1 2 0 2 4 1
1 4 0 2 8 1 1 1
1 1 1 1 2 1 1 1
1 1 1 1 4 1 1 1
1 1 1 1 1 1 1 1