9 9
1 1 1 1 1 1 1 1 1
1 0 0 8 1 1 1 1 1
1 0 2 2 1 1 1 1 1
1 0 2 0 1 1 1 4 1
1 1 1 0 1 1 1 4 1
1 1 1 0 0 0 0 4 1
1 1 0 0 0 1 0 0 1
1 1 0 0 0 1 1 1 1
1 1 1 1 1 1 1 1 1